....................##....
....................##....
..##~~~~..@@..##..........
..##~~~~..@@..##..........
....~~~~##%%%%%%~~~~..@@..
....~~~~##%%%%%%~~~~..@@..
..........%%%%%%~~~~##....
..........%%%%%%~~~~##....
..@@....~~~~..%%..........
..@@....~~~~..%%..........
%%%%##..~~~~@@........##..
%%%%##..~~~~@@........##..
%%%%%%............@@....@@
%%%%%%............@@....@@
..##~~~~..##..............
..##~~~~..##..............
@@..~~~~%%%%~~~~%%%%..##..
@@..~~~~%%%%~~~~%%%%..##..
........%%..~~~~%%%%~~~~..
........%%..~~~~%%%%~~~~..
......@@%%......%%%%~~~~..
......@@%%......%%%%~~~~..
....##..##................
....##..##.####...........
##.........#..#...##@@....
##.........#..#...##@@....
RRRRRRRRRRAAAABBBBBB