........@@........@@......
........@@........@@......
..@@......@@....@@%%%%....
..@@......@@....@@%%%%....
....@@........@@%%..@.....
....@@........@@%%@@@.....
......@@..%%%%%%%%%%...@..
......@@..%%%%%%%%%%...@..
..@.....@@%%%%@@%%....@@..
..@.....@@%%%%@@%%....@@..
..@@@.%%..@@%%%%@@.....@..
....@.%%..@@%%%%@@.....@..
....%%%%%%%%%%....@@......
....%%%%%%%%%%....@@......
....@.%%..@@%%......@@....
..@@@.%%..@@%%......@@....
..%%%%%%@@..@@........@@..
..%%%%%%@@..@@..@@....@@..
%%%%%%@@.........@........
%%%%%%@@.........@........
....@@.................@@@
....@@.................@@@
....................@.....
...........####...@@@.....
@..........#..#...........
@...@@.....#..#...........
AAAABBBBBBBBRRRRAAAA